area - [ eəriə ] (Эриа) - площадь
book - [ bʊk ] (бук) - книга
business - [ biznis ] (бизнис) - бизнес
case - [ keɪs ] (кэйс) - дело
child - [ tʃaɪld ] (чайлт) - ребенок
company - [ kʌmpəni ] (кАмпэни) - компания
country - [ kʌntri ] (кАнтри) - страна
day - [ deɪ ] (дэй) - день
eye - [ aɪ ] (ай) - глаз
fact - [ fækt ] (фЭкт) - факт
family - [ fæməli ] (фЭмэли) - семья
government - [gʌvəmənt] (гАвэмэнт) - правительство
group - [ ɡruːp ] (гру:п) - группа
hand - [ hænd ] (хЭнд) - рука
home - [ həʊm ] (хэум) - дом
job - [ dʒɒb ] (джоб) - работа
life - [ laɪf ] (лайф) - жизнь
lot - [ lɒt](лот) - много
man - [ mæn ] (мЭн) - мужчина
money - [ mʌni ] (мани) - деньги
month - [ mʌnθ ] (манθ)- месяц
mother - [ mʌðə ] (маðэ )- мама
Mr - [ mɪstə ] (миста) - Мистер
night - [ naɪt ] (найт) - ночь
number - [ nʌmbə ] (намба) - номер
part - [ pɑːt ] (па:т) - часть
people - [ piːpl ] ( пи:пл ) - люди
place - [ pleɪs ] (плэйс) - место
point - [point] (поинт) - точка
problem - [ prɒbləm ] (проблим) - проблема
program - [ prəʊɡræm ] (проугрэм) - программа
question - [ kwestʃən ] (квэсчин) - вопрос
right - [ raɪt ] (райт) - правильно
room - [ ruːm ](ру:м)- комната
school - [ skuːl ] (ску:л) - школа
state - [ steɪt ] (стэйт) - государство
story - [ stɔːri ] (сто:ри) - история
study - [ stʌdi ](стАди)- изучение
system -[ sɪstəm ] (сИстэм) - система
thing - [ θɪŋ ] ( θин(г) - вещь
time - [ taɪm ] (тайм) - время
water - [ wɔːtə ] (вотэ) - вода
way - [ weɪ ] (вэй) - путь
week - [ wiːk ] (ви:к) - неделя
woman - [ wʊmən ] (вумэн) - женщина
word - [ wɜːd ] (вёд) - слово
work - [ wɜːk ] (вёк) - работа
world - [ wɜːld ] (вё(р)лд) - мир
year - [ jɪə(r) ] (йеа) - год